TROPHOSPECIES	ABBREVIATION	GROUP
DETRITUS	DET_IND	1_Basal
AUTOTHROPH_FLAGELLAT	AUT_FLA	1_Basal
BACTERIA_INDET	BAC_IND	1_Basal
DIATOM	DIATOM	1_Basal
HETEROTROPH_FLAGELLAT	HET_FLA	1_Basal
ICE_ALGAE	ICE_ALG	1_Basal
MACROALGAE	MAC_IND	1_Basal
MIXOTROPH_FLAGELLATES	MIX_FLA	1_Basal
PHYTOPLANKTON_INDET	PHY_IND	1_Basal
PROTOZOOPLANKTON	PROZOO	1_Basal
ACARTIA_SPP	ACA_SPP	2_Zooplankton
AGLANTHA_DIGITALE	AGL_DIG	2_Zooplankton
APHERUSA_GLACIALIS	APH_GLA	2_Zooplankton
AURELIA_AURITA	AUR_AUR	2_Zooplankton
BEROE_SP	BER_SP	2_Zooplankton
BOLINOPSIS_INFUNDIBULUM	BOL_INF	2_Zooplankton
CALANUS_FINMARCHICUS	CAL_FIN	2_Zooplankton
CALANUS_GLACIALIS	CAL_GLA	2_Zooplankton
CALANUS_HYPERBOREUS	CAL_HYP	2_Zooplankton
CLIONE_LIMACINA	CLI_LIM	2_Zooplankton
CYANEA_CAPILLATA	CYA_CAP	2_Zooplankton
DIMOPHYES_ARCTICA	DIM_ARC	2_Zooplankton
EUKROHNIA_HAMATA	EUK_HAM	2_Zooplankton
EUPHYSA_FLAMMEA	EUP_FLAM	2_Zooplankton
FRITILLARIA_BOREALIS	FRI_BOR	2_Zooplankton
GAMMARUS_WILKITZKII	GAM_WIL	2_Zooplankton
LIMACINA_HELICINA	LIM_HEL	2_Zooplankton
LIMACINA_RETROVERSA	LIM_RET	2_Zooplankton
MEGANYCTIPHANES_NORVEGICA	MEG_NOR	2_Zooplankton
MERTENSIA_OVUM	MER_OVU	2_Zooplankton
METRIDIA_LONGA	MET_LON	2_Zooplankton
METRIDIA_LUCENS	MET_LUC	2_Zooplankton
MICROCALANUS_SPP	MIC_SPP	2_Zooplankton
NEMATOSCELIS_MEGALOPS	NEM_MEG	2_Zooplankton
OIKOPLEURA_DIOICA	OIK_DIO	2_Zooplankton
OIKOPLEURA_SPP	OIK_SPP	2_Zooplankton
OIKOPLEURA_VANHOEFFENI	OIK_VAN	2_Zooplankton
OITHONA_SIMILIS	OIT_SPI	2_Zooplankton
OITHONA_SPINIROSTRIS/ATLANTICA	OIT_SIM	2_Zooplankton
ONCAEA_BOREALIS	ONC_BOR	2_Zooplankton
ONISIMUS_GLACIALIS	ONI_GLA	2_Zooplankton
ONISIMUS_NANSENI	ONI_NAN	2_Zooplankton
PAREUCHAETA_GLACIALIS	PAR_GLA	2_Zooplankton
PAREUCHAETA_NORVEGICA	PAR_NOR	2_Zooplankton
PAREUCHAETA_SPP	PAR_SPP	2_Zooplankton
PSEUDOCALANUS_SPP	PSE_SPP	2_Zooplankton
SAGITTA_SPP	SAG_SPP	2_Zooplankton
SARSIA_SPP	SAR_SPP	2_Zooplankton
THEMISTO_ABYSSORUM	THE_ABY	2_Zooplankton
THEMISTO_LIBELLULA	THE_LIB	2_Zooplankton
THYSANOESSA_INERMIS	THY_INE	2_Zooplankton
THYSANOESSA_LONGICAUDATA	THY_LON	2_Zooplankton
THYSANOESSA_RASCHII	THY_RAS	2_Zooplankton
ACTINIARIA_G_SP	ACT_G_SP	3_Benthos
AGLAOPHAMUS_MALMGRENI	AGL_MAL	3_Benthos
APHELOCHAETA_MARIONI	APH_MAR	3_Benthos
ARRHIS_PHYLLONYX	ARR_PHY	3_Benthos
ASCIDIACEA_G_SP	ASC_G_SP	3_Benthos
ASELLOTA_INDET	ASE_IND	3_Benthos
ASTARTE_SP	AST_SP	3_Benthos
ASTERIAS_RUBENS	AST_RUB	3_Benthos
BALANUS_SP	BAL_SP	3_Benthos
BATHYARCA_GLACIALIS	BAT_GLA	3_Benthos
BRYOZOA_INDET	BRY_IND	3_Benthos
BENTHOS_LARVAE	BEN_LAR	3_Benthos
BUCCINUM_SP	BUC_SP	3_Benthos
CHAETOZONE_SP	CHA_SP	3_Benthos
CHIONOECETES_OPILIO	CHI_OPI	3_Benthos
CHLAMYS_ISLANDICA	CHL_ISL	3_Benthos
CHONE_SP	CHO_SP	3_Benthos
CIONA_INTESTINALIS	CIO_INT	3_Benthos
CIRRATULIDAE_INDET	CIR_IND	3_Benthos
COLUS_SP	COL_SP	3_Benthos
CROSSASTER_PAPPOSUS	CRO_PAP	3_Benthos
CTENODISCUS_CRISPATUS	CTE_CRI	3_Benthos
CUCUMARIA_FRONDOSA	CUC_FRO	3_Benthos
ELECTRA_ARCTICA	ELE_ARC	3_Benthos
ERYTHROPS_SP	ERY_SP	3_Benthos
EUCLYMENINAE_INDET	EUC_IND	3_Benthos
FORAMINIFERA	FOR_IND	3_Benthos
GALATHOWENIA_SP	GAL_SP	3_Benthos
GAMMARIDAE_INDET	GAM_IND	3_Benthos
GEODIA_SP	GEO_SP	3_Benthos
GONATUS_FABRICII	GON_FAB	3_Benthos
GORGONOCEPHALUS_SP	GOR_SP	3_Benthos
HELIOMETRA_GLACIALIS	HEL_GLA	3_Benthos
HETEROMASTUS_FILIFORMIS	HET_FIL	3_Benthos
HYAS_SP	HYA_SP	3_Benthos
HYDROZOA_INDET	HYD_IND	3_Benthos
LUMBRICLYMENE_MINOR	LUM_MIN	3_Benthos
LUMBRINERIS_SP	LUM_SP	3_Benthos
MACOMA_SP	MAC_SP	3_Benthos
MALDANE_SARSI	MAL_SAR	3_Benthos
MENDICULA_FERRUGINOSA	MEN_FER	3_Benthos
MOLPADIA_BOREALIS	MOL_BOR	3_Benthos
MYRIOCHELE_HERRI	MYR_HEE	3_Benthos
NEPHTHEIDAE_SP	NEP_SP	3_Benthos
NYCTIPHANES_COUCHII	NYC_COU	3_Benthos
OPHIACANTHA_BIDENTATA	OPH_BID	3_Benthos
OPHIOCTEN_SERICEUM	OPH_SER	3_Benthos
OPHIOPHOLIS_ACULEATA	OPH_ACU	3_Benthos
OPHIOPLEURA_BOREALIS	OPH_BOR	3_Benthos
OPHIOSCOLEX_GLACIALIS	OPH_GLA	3_Benthos
OPHIURA_SP	OPH_SP	3_Benthos
OSTRACODA_INDET	OST_IND	3_Benthos
PAGURUS_SP	PAG_SP	3_Benthos
PANDALUS_BOREALIS	PAN_BOR	3_Benthos
PARALITHODES_CAMTSCHATICUS	PAR_CAM	3_Benthos
PARAMPHINOME_JEFFREYSII	PAR_JEF	3_Benthos
PHASCOLION_STROMBUS	PHA_STR	3_Benthos
POLYCHAETA	POL_IND	3_Benthos
POLYNOIDAE_INDET	POLY_IND	3_Benthos
PONTASTER_TENUISPINUS	PON_TEN	3_Benthos
PONTOPHILUS_NORVEGICUS	PON_NOR	3_Benthos
PORIFERA_G_SP	POR_G_SP	3_Benthos
PRIONOSPIO_CIRRIFERA	PRI_CIR	3_Benthos
PYCNOGONIDA_G_SP	PYC_G_SP	3_Benthos
RHACHOTROPIS_SP	RHA_SP	3_Benthos
ROSSIA_SP	ROS_SP	3_Benthos
SABINEA_SP	SAB_SP	3_Benthos
SCALIBREGMA_INFLATUM	SCA_INF	3_Benthos
SCLEROCRANGON_SP	SCL_SP	3_Benthos
SIMILIPECTEN_GREENLANDICUS	SIM_GRE	3_Benthos
SPIOCHAETOPTERUS_TYPICUS	SPI_TYP	3_Benthos
SPIOPHANES_KROEYERI	SPI_KRO	3_Benthos
SPIRORBIDAE_INDET	SPI_IND	3_Benthos
STICHOPUS_TREMULUS	STI_TRE	3_Benthos
STRONGYLOCENTROTUS_SP	STRO_SP	3_Benthos
TEREBELLIDES_STROEMI	TER_STRO	3_Benthos
THYASIRA_GOULDI	THY_GOU	3_Benthos
URASTERIAS_LINCKII	URA_LIN	3_Benthos
YOLDIELLA_SOLIDULA	YOL_SOL	3_Benthos
AGONUS_CATAPHRACTUS	AGO_CAT	4_Fish
AMBLYRAJA_HYPERBOREA	AMB_HYP	4_Fish
AMBLYRAJA_RADIATA	AMB_RAD	4_Fish
AMMODYTES_SPP	AMM_SPP	4_Fish
ANARHICHAS_DENTICULATUS	ANA_DEN	4_Fish
ANARHICHAS_LUPUS	ANA_LUP	4_Fish
ANARHICHAS_MINOR	ANA_MIN	4_Fish
ANISARCHUS_MEDIUS	ANI_MED	4_Fish
ARCTOGADUS_GLACIALIS	ARC_GLA	4_Fish
ARCTOZENUS_RISSO	ARC_RIS	4_Fish
ARGENTINA_SP	ARG_SP	4_Fish
ARTEDIELLUS_ATLANTICUS	ART_ATL	4_Fish
BATHYRAJA_SPINICAUDA	BAT_SPI	4_Fish
BENTHOSEMA_GLACIALE	BEN_GLA	4_Fish
BOREOGADUS_SAIDA	BOR_SAI	4_Fish
BROSME_BROSME	BRO_BRO	4_Fish
CAREPROCTUS_SP	CAR_SPP	4_Fish
CLUPEA_HARENGUS	CLU_HAR	4_Fish
COTTUNCULUS_MICROPS	COT_MIC	4_Fish
CYCLOPTERUS_LUMPUS	CYC_LUM	4_Fish
ENCHELYOPUS_CIMBRIUS	ENC_CIM	4_Fish
ETMOPTERUS_SPINAX	ETM_SPI	4_Fish
EUMICROTREMUS_SPINOSUS	EUM_SPI	4_Fish
GADICULUS_ARGENTEUS	GAD_ARG	4_Fish
GADUS_MORHUA	GAD_MOR	4_Fish
GAIDROPSARUS_ARGENTATUS	GAI_ARG	4_Fish
GASTEROSTEUS_ACULEATUS	GAS_ACU	4_Fish
GLYPTOCEPHALUS_CYNOGLOSSUS	GLY_CYN	4_Fish
GYMNELUS_SPP	GYM_SPP	4_Fish
GYMNOCANTHUS_TRICUSPIS	GYM_TRI	4_Fish
HIPPOGLOSSUS_HIPPOGLOSSUS	HIP_HIP	4_Fish
HIPPOGLOSSOIDES_PLATESSOIDES	HIP_PLA	4_Fish
ICELUS_SPP	ICE_SPP	4_Fish
LEPTAGONUS_DECAGONUS	LEP_DEC	4_Fish
LEPTOCLINUS_MACULATUS	LEP_MAC	4_Fish
LIMANDA_LIMANDA	LIM_LIM	4_Fish
LIPARIS_FABRICII	LIP_FAB	4_Fish
LIPARIS_GIBBUS	LIP_GIB	4_Fish
LIPARIS_MONTAGUI	LIP_MON	4_Fish
LUMPENUS_FABRICII	LUM_FAB	4_Fish
LUMPENUS_LAMPRETAEFORMIS	LUM_LAM	4_Fish
LYCENCHELYS_KOLTHOFFI	LYC_KOL	4_Fish
LYCODES_ESMARKII	LYC_ESM	4_Fish
LYCODES_EUDIPLEUROSTICTUS	LYC_EUD	4_Fish
LYCODES_GRACILIS	LYC_GRA	4_Fish
LYCODES_PALLIDUS	LYC_PAL	4_Fish
LYCODES_RETICULATUS	LYC_RET	4_Fish
LYCODES_ROSSI	LYC_ROS	4_Fish
LYCODES_SEMINUDUS	LYC_SEM	4_Fish
MACROURUS_BERGLAX	MAC_BER	4_Fish
MALLOTUS_VILLOSUS	MAL_VIL	4_Fish
MAUROLICUS_MUELLERI	MAU_MUE	4_Fish
MELANOGRAMMUS_AEGLEFINUS	MEL_AEG	4_Fish
MERLANGIUS_MERLANGUS	MER_MER	4_Fish
MICROMESISTIUS_POUTASSOU	MIC_POU	4_Fish
MICROSTOMUS_KITT	MIC_KIT	4_Fish
MOLVA_MOLVA	MOL_MOL	4_Fish
MYOXOCEPHALUS_SCORPIUS	MYO_SCO	4_Fish
PARALIPARIS_BATHYBIUS	PAR_BAT	4_Fish
FISH_LARVAE	FI_LA	4_Fish
PLEURONECTES_PLATESSA	PLE_PLA	4_Fish
POLLACHIUS_POLLACHIUS	POL_POL	4_Fish
POLLACHIUS_VIRENS	POL_VIR	4_Fish
RAJELLA_FYLLAE	RAJ_FYL	4_Fish
REINHARDTIUS_HIPPOGLOSSOIDES	REI_HIP	4_Fish
SCOMBER_SCOMBRUS	SCO_SCO	4_Fish
SEBASTES_MARINUS	SEB_MAR	4_Fish
SEBASTES_MENTELLA	SEB_MEN	4_Fish
SEBASTES_SPP	SEB_SPP	4_Fish
SEBASTES_VIVIPARUS	SEB_VIV	4_Fish
SOMNIOSUS_MICROCEPHALUS	SOM_MIC	4_Fish
SQUALUS_ACANTHIAS	SQU_ACA	4_Fish
TRIGLOPS_MURRAYI	TRI_MUR	4_Fish
TRIGLOPS_NYBELINI	TRI_NYB	4_Fish
TRIGLOPS_PINGELII	TRI_PIN	4_Fish
TRISOPTERUS_ESMARKII	TRI_ESM	4_Fish
ULCINA_OLRIKII	ULC_OLR	4_Fish
ALLE_ALLE	ALL_ALL	5_Birds
FRATERCULA_ARCTICA	FRA_ARC	5_Seabirds
FULMARUS_GLACIALIS	FUL_GLA	5_Seabirds
LARUS_ARGENTATUS	LAR_ARG	5_Seabirds
LARUS_HYPERBOREUS	LAR_HYP	5_Seabirds
LARUS_MARINUS	LAR_MAR	5_Seabirds
RISSA_TRIDACTYLA	RIS_TRI	5_Seabirds
URIA_AALGE	URI_AAL	5_Seabirds
URIA_LOMVIA	URI_LOM	5_Seabirds
BALAENOPTERA_ACUTOROSTRATA	BAL_ACU	6_Mammals
BALAENOPTERA_PHYSALUS	BAL_PHY	6_Mammals
CYSTOPHORA_CRISTATA	CYS_CRI	6_Mammals
DELPHINAPTERUS_LEUCAS	DEL_LEU	6_Mammals
ERIGNATHUS_BARBATUS	ERI_BAR	6_Mammals
LAGENORHYNCHUS_ALBIROSTRIS	LAG_ALB	6_Mammals
MEGAPTERA_NOVAEANGLIAE	MEG_NOV	6_Mammals
MONODON_MONOCEROS	MON_MON	6_Mammals
ODOBENUS_ROSMARUS	ODO_ROS	6_Mammals
ORCINUS_ORCA	ORC_ORC	6_Mammals
PAGOPHILUS_GROENLANDICUS	PAG_GRO	6_Mammals
PHOCA_HISPIDA	PHO_HIS	6_Mammals
PHOCOENA_PHOCOENA	PHO_PHO	6_Mammals
PHYSETER_MACROCEPHALUS	PHY_MAC	6_Mammals
URSUS_MARITIMUS	URS_MAR	6_Mammals